XXXXXXXXX
X       S
XXXXXXX X
X     X X
X XXX X X
X   X   X
XXXEXXXXX
